10 20
|------------------|
|@......|.........-|
|.-----.|.------.##|
|.|...........|...-|
|.|.--.----.|.|.+.-|
|...|.......|.|...-|
|.--|.-.---.-.|.--.|
|.+.....|.........-|
|----|....|.---.--.|
|------------------|
