5 10 
|--------|
|.#.|..-.|
|..-|.@..|
|.#....-.|
|--------|
