5 10 
|--------|
|.#.|..-.|
|..-|.@+.|
|.#....-.|
|--------|
